"Given that 3<super>3</super> is 27, what is 3<super>4</super>?"	81	math	56
Gerald Ford was sworn into office when what President resigned?	Richard Nixon	socialstudies	56
"If 6 times <i>x</i> equals 78, what does <i>x</i> times 4 equal?"	52	math	56
"Identify the proper nouns in the sentence, ""The captain sailed his ship to Africa and Asia."""	"Africa, Asia"	geography	56
What compound that enters plant leaves through tiny holes called stomata is converted by the plant into sugar and water?	Carbon dioxide	science	56
Name the ship that left England in 1620 carrying a load of Pilgrims headed for the New World. 	Mayflower	socialstudies	56
Who is the President from the state of Missouri who gave the order to drop both atomic bombs on the country of Japan in 1945?	(Harry S) Truman	socialstudies	
"Who is the colloquial author who grew up in Hannibal, Missouri, who penned works such as The Prince and the Pauper and The Adventures of Huckleberry Finn?"	Mark Twain (Samuel Clemens)	literature	
What is the city that is named after a President and serves as the state capitol of Missouri?	Jefferson City	geography	
"Comprising of 18% of the human body, what element that has the symbol of C is the second most common element in the human body?"	Carbon  	science	
Who is the 35th President who is also known for being the first Catholic President of the United States?	(John F) Kennedy	socialstudies	
What is the name for the collection of mysteries about a sharp-witted detective published in 1892 by British author Arthur Conan Doyle?	The Adventures of Sherlock Holmes	literature	
What is the name for the capitol city of Massachusetts that is the site of the United States' most famous tea party?	Boston	geography	
What is name of this element with the atomic number of 7 that makes up the largest percentage of gas in Earth's atmosphere?	Nitrogen	science	
What is the name of the 28th President who unsuccessfully tried to keep the United States out of World War I?	Woodrow Wilson	socialstudies	
"Who famously penned the novel about a curious young girl named Alice, a Cheshire cat, a mad hatter, and an irate queen obsessed with decapitation?"	Lewis Carroll	literature	
Lincoln is the capitol of what state known for having the United States' only unicameral legislature?	Nebraska	geography	
"Which President, whose home is known as Monticello, was the primary author of the Declaration of Independence?"	Thomas Jefferson	socialstudies	
What is the name of the book by L.M. Montgomery about a young red-haired girl growing up on Prince Edward Island in Canada?	Anne of Green Gables	literature	
What is the name of the state capitol city that sits in the panhandle of Florida?	Tallahassee	geography	
"It is, by mass, the most common element on Earth. What is the name of the element with the symbol Fe?"	Iron	science	
What is the full name of the first President whose father was also President?	John Quincy Adams	socialstudies	
"In Charles Dickens's work A Tale of Two Cities, what are the two cities?"	Paris and London	literature	
What is the name of the current state capitol that formerly served as the capitol city of the Confederacy?	"Richmond, Virginia"	socialstudies	
What element is the most abundant mineral in the body?	Calcium	science	
